==============================
|         |                  |
|   P ====|==========        |
|                            |
|       =========            |
|      |   .     |     ==|   |
|      |====     |       |   |
|                        |   |
==============================
