1 9 30
==============================
|         |                  |
|     ====|==========        |
|                            |
|       =========            |
|      |   P     |     ==|   |
|      |====     |       |   |
|       .                |   |
==============================
