==============
|P           |
|            |
|  |G   G |  |
|  ========  |
|            |
|========    |
|  .         |
|            |
==============