2 10 14
==============
|P           |
|            |
|  |G.  G |  |
|  ========  |
|            |
|========    |
|            |
|            |
==============
