3 10 10
==========
|P  . .  |
|    ====|
|  .    G|
|    |   |
| .  ====|
|   =| G |
| G      |
|    .   |
==========
