4 10 10
==========
| P  G   |
|    ====|
|        |
|    |   |
| .  ====|
|   =| . |
|  .     |
|      . |
==========
